012421321232142123211
020212050204020201002
020200354112020120122
023030503020010300002
020200304012004002024
022010201230200104002
021023020402021021021
021010330202010400002
020210210203010220021
020204020130020200002
021030310230010202011
001010302010102041012
012030100012200202001
002020020126200020102