000000000000000000000
333333333333333333333
444444444444444444444
333333333333333333333
444444444444544444444
333333333330333333333
444444404125244444444
333333333333333333333
444444444444444444444
333333333333333333333
444444444444444444444
333333333333333333333
111111111111111111111
000000000060000000220
