000000000000000000000
000000100000001000000
000001010000010100000
000010001000100010000
000100000111000001000
001000000000000000100
000100000050000001000
000010000000000010000
000001000000000100000
000000100000001000000
000000010000010000000
000000001111100000000
000000000000000000000