0500000000000000000111
0110101010101010110111
0110101010101010110111
1110101010101010111111
2110101012101010112101
0110101000001010110101
1010000000011100000000
0110101016100101010101
2110101012101010112101
1110101010101010111101
0110101010101010110101
0000000000000000000000
0110101022221010110101
0000000002620000000101