5555000000000000000000
3333333333333333333333
3333333333333333333333
3333333333333333333333
3333333333333333333333
3333333333333333333333
3333333333333333333333
3333333333333333333333
3333333333333333333333
1111111111111111111111
1111111111111111111111
1111111111111111111111
0000000001111000000000
0000000001661000000000