5544444444444444444000
0000011111111111000000
0000100000000000100000
0001011100000111010000
0010200020002000201000
0100222220002222200100
0100300002020000300100
0100300000000000300100
0010301111111110301000
0001000220002200010000
0000100220002200100000
0000010001110001000000
0000000002220000000000
0050001002620010000000