0000000555555000000000
1111113333111111111000
0000000000000000000000
1110000044444444444000
0000000020200000000000
0000000020200000000000
0000000000000000000000
3333330000003333333333
4440004440004440000000
1111111111111111111111
1100101101010101011000
1111113311114422111000
0000000001610000000000